
Little Alchemy (Маленькая алхимия) ответы: А

Автобус = автомобиль + автомобиль
Автомобиль = колесо + металл
Айсберг = океан + Антарктика = океан + лёд = море + Антарктика = море + лёд
Аквариум = стекло + рыба = стекло + вода
Акула = океан + кровь = океан + дикое животное = море + кровь = море + дикое животное
Алкоголик = алкоголь + человек
Алкоголь = время + фрукт = время +сок
Аллергия = человек + пыль
Аллигатор = ящерица + река = ящерица + болото
Алмаз = уголь + время = уголь + давление
Альпака = гора + овца
Амбар = дом + корова = дом + сено = дом + скот
Ангел = человек + птица
Антарктика = пустыня + лёд = пустыня + снег
Арфа = ангел + музыка
Архипелаг = остров + остров
Астронавт = человек + луна = человек + космос = человек + космическая станция = человек + ракета
Атомная бомба = энергия + взрыв
Атмосфера = давление + воздух = давление + небо

Little Alchemy (Маленькая алхимия) ответы: Б

Бабочка = цветок + дикое животное
Бактерия = болото + жизнь
Банан = фрукт + обезьяна
Бандаж = кровь + ткань
Банк = дом + золото = дом + деньги
Барабан = древесина + кожа
Барбекю = костёр + сад = костёр + мясо
Бегемот = лошадь + река = лошадь + вода
Бекон = свинья + огонь
Белка = мышь + дерево
Белка-летяга = белка + самолёт = белка + птица = белка + небо = белка + ветер
Бензопила = топор + электричество
Блендер = лезвие + электричество = стекло + лезвие
Бобёр = дикое животное + плотина = дикое животное + древесина
Бойлер = пар + металл
Болезнь = человек + бактерия = человек + дождь
Болото = грязь + трава = грязь + растение
Больница = дом + скорая помощь = дом + доктор = дом + болезнь
Броненосец = дикое животное + броня
Броня = инструмент + металл = инструмент + сталь
Будильник = часы + звук
Бумага = древесина + давление
Бумажный самолётик = самолёт + бумага
Бэтмен = летучая мышь + человек

Little Alchemy (Маленькая алхимия) ответы: В

Вагон = телега + лошадь
Ваза = растение + кувшин = кувшин + цветок
Вампир = человек + кровь
Веб = паук + нить
Ведьма = человек + метла = маг + метла
Велосипед = колесо + колесо
Велосипедист = велосипед + человек
Верблюд = пустыня + дом = пустыня + дикое животное = пустыня + скот = пустыня + лошадь
Веревка = нить + нить
Вертолёт = лезвие + самолёт
Ветер = воздух + энергия = давление + воздух
Ветряная турбина = мельница + электричество
Ветчина = мясо + дым
Взрыв = порох + огонь
Вилы = инструмент + сено
Вино = фрукт + алкоголь
Водопад = гора + река
Водопровод = вода + труба
Водоросли = океан + растение = море + растение = вода + растение
Водяная лилия = цветок + пруд
Водяной пистолет = вода + пистолет
Воздушный змей = небо + бумага = ветер + бумага
Воин = меч + человек
Волна = океан + ветер = море + ветер
Волшебная палочка = маг + дерево
Ворон = птица + поле = птица + пугало
Воск = пчела + улей
Время = песок + стекло
Вулкан = огонь + гора = лава + земля = лава + гора
Волк = собака + лес = дикое животное + собака = дикое животное + луна

Little Alchemy (Маленькая алхимия) ответы: Г

Газета = бумага + бумага
Газировка = сок + углекислый газ = вода + углекислый газ
Газонокосилка = электричество + коса = трава + инструмент
Галактика = звезда + звезда
Гамбургер = мясо + хлеб
Гейзер = пар + земля
Герой = рыцарь + дракон
Гидросамолет = самолет + океан = самолет + море = самолет + вода
Глина = песок + грязь
Гнездо = птица + сено = птица + дерево = яйцо + сено
Годзилла = динозавр + город
Голем = глина + жизнь
Голубь = птица + город = птица + письмо = птица + статуя
Гора = землетрясение + земля
Горизонт = океан + небо = море + небо = небо + земля
Горный хребет = гора + гора
Горнолыжные очки = очки + снег
Город = небоскрёб + небоскрёб = деревня + деревня
Град = лёд + облако = лёд + шторм = лёд + дождь
Граната = взрыв + металл
Гриф = птица + труп
Гроб = древесина + труп
Грузовик с мороженым = автомобиль + мороженое
Грязь = вода + земля

Little Alchemy (Маленькая алхимия) ответы: Д

Давление = воздух + воздух = земля + земля
Дарт Вейдер = джедай + огонь = джедай + лава
Двойная радуга = радуга + радуга
День = ночь + солнце = небо + солнце = солнце + время = время + ночь
Деньги = бумага + золото
Деревня = дом + дом
Дерево = растение + время
Джедай = световой меч + человек = световой меч + рыцарь
Джем = сок + сахар
Дикое животное = лес + жизнь
Динамит = порох + провод
Динозавр = ящерица + время
Дождь = облако + вода = вода + воздух
Доктор = человек + больница
Дом = человек + кирпич = инструмент + кирпич = стена + стена = древесина + человек
Дом на дереве = дерево + дом
Дом на колёсах = дом + автомобиль
Дракон = ящерица + огонь
Древесина = инструмент + дерево
Древесный уголь = дерево + огонь = древесина + огонь
Дровосек = топор + человек = человек + бензопила
Дровяной домик = древесина + дом
Дым = огонь + древесина
Дымоход = камин + кирпич = дом + камин = дым + кирпич
Дюна = пляж + ветер = пустыня + ветер = песок + ветер
Дятел = птица + древесина

Little Alchemy (Маленькая алхимия) ответы: Е
Единорог = двойная радуга + лошадь = двойная радуга + жизнь = радуга + лошадь = радуга + жизнь

Little Alchemy (Маленькая алхимия) ответы: Ж

Жареный сыр = сыр + тост
Жидкое тесто = мука + молоко
Жизнь = любовь + время = болото + энергия

Little Alchemy (Маленькая алхимия) ответы: З

Забор = стена + древесина
Замок = дом + рыцарь
Замороженый сок = сок + холод = сок + лед
Затмение = солнце + луна
Защитные очки = инженер + очки = взрыв + очки = инструмент + очки
Звезда = ночь + телескоп = небо + ночь
Звук = воздух + волна
Землетрясение = земля + энергия = земля + волна
Зеркало = стекло + металл
Зерно = пшеница + молоко
Зефир = сахар + костёр
Змея = дикое животное + провод
Золото = металл + радуга = металл + солнце
Зомби = труп + жизнь = человек + зомби
Зонт = инструмент +дождь

Little Alchemy (Маленькая алхимия) ответы: И, Й

Игла = металл + сено = металл + нить
Иглу = дом + лёд = дом + снег
Идея = человек + лампочка = лампочка + нерд
Извержение = вулкан + энергия
Икра = рыбья икра + человек
Инженер = человек + инструмент
Инопланетянин = жизнь + космос
Инструмент = металл + человек
Интернет = компьютер + компьютер = компьютер + веб = компьютер + провод
Ископаемые = динозавр + земля = динозавр + камень = динозавр + время
История = человек + костёр
Йода = джедай + болото
Йогурт = молоко + бактерия

Little Alchemy (Маленькая алхимия) ответы: К

Кабан = свинья + лес = свинья + дикое животное
Кактус = пустыня + растение = песок + растение
Камень = воздух + лава
Камин = костёр + кирпич = костёр + стена = дом + костёр
Карамель = сахар + огонь
Карандаш = древесина + древесный уголь = древесина + уголь
Карта = бумага + земля
Карта сокровищ = пират + карта
Картошка фри = подсолнечное масло + овощи
Кентавр = лошадь + человек
Киборг = человек + робот
Кирпич = глина + огонь = глина + солнце = грязь + огонь = грязь + солнце
Кислород = растение + углекислый газ = растение + солнце
Кислотный дождь = дождь + смог = дождь + дым
Клавиатурный кот = кошка + музыка
Кладбище = могила + могила = надгробие + надгробие
Книга = бумага + история = бумага + древесина
Кожа = корова + лезвие = свинья + лезвие
Козёл = скот + гора
Кокос = пальма + фрукт
Кокосовое молоко = кокос + инструмент = молоко + кокос
Колесо = инструмент + дерево
Колибри = птица + цветок
Кольцо = алмаз + золото = алмаз + металл
Кольцо Всевластия = вулкан + кольцо
Компьютер = электричество + нерд = инструмент + нерд = провод + нерд
Компьютерная мышь = мышь + компьютер
Конфета = сахар + новогодняя ёлка
Конфетти = бумага + лезвие = бумага + ножницы
Корова = трава + скот
Коса = лезвие + трава = лезвие + пшеница
Космическая станция = космос + дом
Космический корабль = самолет + астронавт
Космос = луна + звезда = небо + звезда = солнце + звезда
Костёр = огонь + древесина
Кость = труп + время
Кошачья мята = кошка + растение
Кошка = дикое животное + молоко
Краска = вода + карандаш = вода + радуга
Кровь = человек + лезвие
Крыса = парусная лодка + дикое животное = дикое животное + пиратский корабль
Кувшин = глина + инструмент = глина + колесо = огонь + глина
Кукушка = часы + птица
Куриные крылышки = курица + кость
Куриный суп = вода + курица
Курица = птица + фермер = яйцо + скот = скот + птица

Little Alchemy (Маленькая алхимия) ответы: Л

Лава = земля + огонь
Лавина = энергия + снег
Лавовая лампа = лава + лампа
Ламантин = корова + море
Лампа = металл + лампочка
Лампочка = электричество + стекло
Лев = дикое животное + кошка
Лед = вода + холод
Ледник = лёд + гора
Лезвие = металл + камень
Ленивец = дикое животное + время
Лес = дерево + дерево
Летучая мышь = мышь + птица = мышь + небо
Летучая рыба = рыба + птица = небо + рыба
Лимонад = фрукт + вода
Линейка = древесина + карандаш
Лиса = курица + дикое животное
Лист = дерево + ветер
Лодка = вода + древесина
Лошадь = сено + скот
Лужа = снеговик + огнемет = солнце + лед = солнце + снеговик
Луна = небо + сыр = небо + камень
Любовь = человек + человек
Лягушка = дикое животное + пруд

Little Alchemy (Маленькая алхимия) ответы: М

Маг = человек + энергия
Майонез = яйцо + подсолнечное масло
Maк и сыр = сыр + паста
Масло = энергия + молоко = молоко + давление
Маяк = свет + пляж = свет + дом = свет + океан = свет + море
Мед = пчела + улей = пчела + цветок
Медуза = человек + змея
Металл = огонь + камень
Мельница = дом + ветер = колесо + ветер
Метеор = метеорит + атмосфера = небо + метеорит
Метеорит = камень + космос
Метла = древесина + сено
Меч = лезвие + металл = лезвие + сталь
Минотавр = человек + корова
Могила = гроб + земля = труп + земля
Молоко = корова + человек = фермер + корова
Молоток = металл + древесина
Молочный коктейль = молоко + мороженое
Монарх = экскалибур + человек = человек + замок
Море = вода + вода
Мороженое = молоко + холод = молоко + лёд
Мороженое космонавтов = мороженое + астронавт
Морская болезнь = лодка + болезнь = болезнь + океан = болезнь + море = пароход + болезнь
Морская звезда = рыба + звезда = океан + звезда = море + звезда
Морской конек = рыба + лошадь = лошадь + море = океан + лошадь
Моряк = человек + лодка = человек + парусная лодка
Мост = река + металл = река + сталь = река + древесина
Мотоцикл = велосипед + энергия = велосипед + сталь
Мох = водоросль + камень = растение + камень
Музыка = человек + флейта = человек + звук
Мука = пшеница + камень = мельница + пшеница
Мумия = труп + пирамида
Муравей = трава + дикое животное = дикое животное + сахар
Мыло = масло + пепел
Мышь = сыр + дикое животное
Мышеловка = металл + сыр = древесина + сыр
Мясник = человек + мясо
Мясо = лезвие + скот = корова + мясник = корова + инструмент = скот + мясник = свинья + мясник = свинья + инструмент

Little Alchemy (Маленькая алхимия) ответы: Н

Наводнение = дождь + дождь = дождь + время
Надгробие = могила + камень
Наждачная бумага = песок + бумага
Нарвал = море + единорог = единорог + океан = единорог + вода
Наручные часы = человек + часы
Небо = воздух + облако
Небоскрёб = дом + небо
Нерд = человек + очки
Несси = история + озеро
Нефть = ископаемое + давление = ископаемое + время
Ниндзя = сюрикен + человек
Нить = хлопок + инструмент = колесо + шерсть
НЛО = самолёт + инопланетянин = ракета + инопланетянин
Новогодняя ёлка = лампочка + дерево = дерево + звезда
Ножницы = лезвие + лезвие
Ноты = бумага + музыка
Ночь = луна + время = небо + луна = время + день

Little Alchemy (Маленькая алхимия) ответы: О

Оазис = пустыня + пальма = пустыня + вода = дерево + пустыня
Обезьяна = дерево + дикое животное
Обёрточная бумага = подарок + бумага
Облако = воздух + пар
Оборотень = волк + человек
Обсидиан = лава + вода
Овощ = поле + фрукт
Овца = облако + скот
Огнемёт = огонь + оружие
Озеро = река + плотина = вода + пруд
Озон = электричество + кислород = кислород + кислород
Океан = море + море = вода + море
Олень = скот + Санта = Санта + дикое животное
Омлет = яйцо + огонь
Оптоволокно = провод + свет
Оранжерея = растение + стекло
Орёл = гора + птица
Оригами = птица + бумага
Оружие = металл + пуля
Остров = океан + вулкан = море + вулкан
Очки = стекло + стекло = стекло + металл
Очки для плавания = очки + вода

Little Alchemy (Маленькая алхимия) ответы: П

Павлин = птица + радуга
Пальма = остров + дерево = дерево + пляж
Пар = вода + энергия = вода + огонь
Паровой двигатель = бойлер + инструмент = бойлер + колесо
Пароход = паровой двигатель + лодка = паровой двигатель + вода
Парусная лодка = лодка + ткань = лодка + ветер
Паста = мука + яйцо
Паук = дикое животное + нить
Пегас = птица + лошадь = птица + единорог = небо + лошадь
Пекарня = дом + пекарь = дом + хлеб
Пекарь = человек + хлеб = человек + тесто = человек + мука
Пепел = вулкан + энергия
Песок = воздух + камень = ветер + камень
Песочные часы = песок + стекло
Песчаная буря = песок + энергия = песок + ураган = песок + шторм
Песчаник = камень + песок
Песчаный замок = песок + замок
Печенье = тесто + сахар
Печенье с предсказаниями = бумага + печенье
Пиво = алкоголь + пшеница
Пикник = пляж + сэндвич = трава + сэндвич
Пилот = самолет + человек = гидросамолет + человек
Пингвин = птица + снег = лёд + птица = лёд + дикое животное
Пиноккио = древесина + жизнь
Пирамида = пустыня + могила = пустыня + камень
Пиранья = рыба + кровь
Пират = моряк + пиратский корабль = меч + моряк
Пиратский корабль = лодка + пират = парусная лодка + пират
Пирог = тесто + фрукт
Пистолет = Пуля + Металл
Письмо = бумага + карандаш
Пицца = сыр + тесто
Планета = земля + космос
Планктон = вода + жизнь
Плесень = время + хлеб
Пловец = человек + очки для плавания
Плотина = бобёр + река = бобёр + дерево = бобёр + древесина = стена + река
Пляж = океан + песок = море + песок = вода + песок
Подарок = Санта + дымоход = Санта + рождественский чулок = Санта + новогодняя ёлка = Санта + печенье = Санта + камин
Подкова = металл + лошадь
Подсолнечное масло = подсолнух + давление
Подсолнух = цветок + солнце = растение + солнце
Поезд = паровой двигатель + металл = паровой двигатель + сталь = паровой двигатель + вагон = паровой двигатель + колесо
Пожарная машина = пожарный + автомобиль
Пожарный = человек + огонь = человек + пожарная машина
Поле = земля + фермер = земля + инструмент
Пончик = тесто + масло
Попугай = птица + пират
Порох = огонь + пыль
Почтальон = человек + письмо
Призма = стекло + радуга
Призрак = замок + ночь = кладбище + ночь
Прилив = океан + луна = море + луна
Принтер = бумага + компьютер
Провод = электричество + металл
Пруд = вода + сад
Пряничный домик = дом + тесто = дом + пряничный человек
Пряничный человек = жизнь + тесто
Птеродактиль = воздух + динозавр = птица + динозавр
Птица = воздух + жизнь = яйцо + воздух = яйцо + небо = жизнь + небо
Пугало = человек + сено
Пуленепробиваемый жилет = пуля + броня
Пуля = порох + металл
Пустыня = песок + кактус = песок + песок
Пушка = порох + замок = порох + пиратский корабль
Пчела = цветок + дикое животное
Пшеница = поле + фермер = растение + фермер
Пьяный = пиво + человек = человек + алкоголь = человек + вино
Пыль = день + вампир = земля + воздух = солнце + вампир

Little Alchemy (Маленькая алхимия) ответы: Р

Радуга = дождь + свет = дождь + солнце
Ракета = самолёт + космос
Растение = дождь + земля
Река = гора + вода = дождь + гора
Рецепт = мука + бумага = бумага + пекарь
Ржавчина = воздух + металл = воздух + сталь = металл + кислород = сталь + кислород
Робот = жизнь + броня = металл + жизнь = сталь + жизнь
Рождественский носок = шерсть + камин
Роза = цветок + любовь = растение + любовь
Роса = туман + трава = вода + трава
Руины = время + замок = время + дом
Русалка = человек + рыба
Рыба = рыбья икра + время
Рыба-меч = рыба + меч
Рыбья икра = яйцо + океан = яйцо + пруд = яйцо + море = яйцо + вода = рыба +рыба
Рыцарь = человек + броня

Little Alchemy (Маленькая алхимия) ответы: С

Сад = цветок + цветок = дом + трава = растение + трава = растение + растение
Садовник = человек + сад
Самолёт = птица + металл = птица + сталь
Санки = снег + телега = снег + вагон
Санта = человек + новогодняя ёлка
Сахар = фрукт + энергия = сок + энергия = сок + огонь
Сверхновая = взрыв + звезда
Свет = электричество + фонарик = лампочка + электричество
Светильник Джека = лезвие + тыква = тыква + свеча = тыква + огонь
Световой меч = меч + электричество = меч + энергия = меч + свет
Свеча = воск + огонь = воск + нить
Свинья = скот + грязь
Свинья-копилка = деньги + кувшин = свинья + деньги
Свитер = человек + шерсть = шерсть + инструмент
Седло = лошадь + кожа
Семья = человек + дом
Семейное древо = дерево + семья
Сено = фермер + трава = трава + вилы = трава + солнце
Серфер = человек + волна
Сигарета = табак + бумага
Скальпель = лезвие + доктор = лезвие + больница
Скворечник = птица + дом
Скейтборд = сноуборд + колесо
Скелет = кость + кость = труп + время
Скорая помощь = доктор + автомобиль = больница + автомобиль
Скорпион = дикое животное + дюна = дикое животное + песок
Скот = фермер + жизнь = фермер + дикое животное = дикое животное + человек
Смepтb с косой = труп + коса = человек + коса
Смог = дым + туман
Снег = дождь + холод = пар + холод
Снеговик = снег + человек = снежок + снежок
Снегоход = снег + автомобиль = снег + мотоцикл
Снежная буря = снег + снег = снег + шторм = снег + ветер
Снежный шар = снег + хрустальный шар
Снежок = снег + человек
Сноуборд = снег + сёрфер = древесина + снег
Собака = дикое животное + человек = волк + кость
Собачка = собака + интернет = собака + компьютер
Собачья будка = собака + дом
Сова = птица + маг = ночь + птица
Созвездие = звезда + звезда
Сок = давление + фрукт = вода + фрукт
Сокровище = пират + карта сокровищ
Солнечная панель = солнце + инструмент
Солнечная система = солнце + планета
Солнечные часы = часы + солнце
Солнце = огонь + небо
Солнцезащитные очки = пляж + очки = солнце + очки
Соль = огонь + океан = огонь + море = океан + солнце = море + солнце
Сталь = металл + уголь
Статуя = инструмент + камень
Стейк = огонь + корова = мясо + барбекю
Стекло = огонь + песок = песок + электричество
Стена = кирпич + кирпич
Стетоскоп = инструмент + доктор
Стог сена = сено + сено
Страус = птица + земля = птица + песок
Сумерки = день + ночь
Сухой лёд = углекислый газ + холод = лёд + углекислый газ
Суши = икра + водоросли = рыба + водоросли
Сфинкс = человек + лев
Сыр = время + молоко
Сэндвич = хлеб + бекон = хлеб + ветчина = сыр + хлеб
Сюрикен = звезда + лезвие

Little Alchemy (Маленькая алхимия) ответы: Т

Табак = растение + огонь
Таймер-яйцо = яйцо + часы = яйцо + наручные часы
Танк = автомобиль + броня = автомобиль + оружие
Телега = колесо + древесина
Телескоп = стекло + небо = стекло + космос = стекло + звезда
Тесто = вода + мука
Тиранозавр Рекс = мясо + динозавр
Титаник = пароход + айсберг
Ткань = нить + инструмент
Топор = лезвие + древесина
Торт = тесто + свеча
Тост = хлеб + огонь = сэндвич + огонь
Трава = растение + земля
Трактор = фермер + автомобиль = поле + автомобиль
Троянский конь = лошадь + дерево
Труба = табак + древесина
Труп = человек + смepтb с косой = человек + оружие
Тукан = птица + радуга
Туман = облако + земля
Тыква = овощ + огонь = овощ + свет
Тюлень = собака + море

Little Alchemy (Маленькая алхимия) ответы: У

Углексилый газ = человек + кислород = растение + ночь = дерево + ночь
Уголь = давление + растение
Удочка = инструмент + рыба = древесина + рыба
Улей = пчела + дом = пчела + дерево
Ураган = ветер + энергия
Утёнок = яйцо + утка
Утка = птица + пруд = вода + птица
Утконос = бобёр + утка

Little Alchemy (Маленькая алхимия) ответы: Ф

Фавн = козёл + человек
Фейерверк = взрыв + небо
Феникс = огонь + птица
Ферма = фермер + амбар = фермер + дом
Фермер = поле + человек = человек + вилы = человек + растение
Флейта = древесина + ветер
Фонтан = статуя + вода
Фонарик = инструмент + свет
Франкенштейн = электричество + труп = зомби + электричество
Фрукт = солнце + дерево = дерево + фермер
Фруктовое дерево = фрукт + дерево
Фруктовый сад = поле + фруктовое дерево = фруктовое дерево + фруктовое дерево

Little Alchemy (Маленькая алхимия) ответы: Х

Хамелеон = ящерица + радуга
Хлеб = тесто + огонь
Хлопок = облако + растение
Холод = человек + дождь
Холодильник = электричество + холод = металл + холод = металл + лёд
Холодный чай = холод + чай = лёд + чай
Хрустальный шар = ведьма + стекло = маг + стекло

Little Alchemy (Маленькая алхимия) ответы: Ц

Цветок = растение + сад
Цунами = океан + землетрясение = море + землетрясение

Little Alchemy (Маленькая алхимия) ответы: Ч
Чай = вода + лист
Чайка = птица + пляж = птица + океан = птица + море
Часы = время + электричество = время + инструмент = время + колесо
Человек = земля + жизнь
Черепаха = яйцо + песок
Черепашка Ниндзя = черепаха + ниндзя
Чёрная дыра = звезда + давление
Чизбургер = сыр + гамбургер

Little Alchemy (Маленькая алхимия) ответы: Ш

Шерсть = ножницы + овца = овца + инструмент
Шторм = облако + электричество = облако + энергия
Штык = оружие + лезвие = оружие + меч

Little Alchemy (Маленькая алхимия) ответы: Э

Экскалибур = меч + камень
Электрик = человек + электричество = человек + провод
Электрический угорь = рыба + электричество
Электричество = свет + солнечная панель = металл + энергия = солнечная панель + солнце = ветряная турбина + ветер
Электромобиль = автомобиль + электричество
Электронная почта = письмо + компьютер почта = письмо + интернет
Электрошокер = оружие + электричество
Энергия = воздух + огонь = растение + солнце

